111111111111111111111111
100000000000000000000001
100000000000000000000001
100000000000000000000001
100000000000000000000001
100000000000000000000001
100000000000001111100001
100000000000001000100001
111111111100001000100001
100000000000001000100001
100000000000000000000001
100000000000000000000001
100000000000000000000001
100000000000000000000001
100000000000000000000001
100000000000000000000001
100000000000000000000001
100000000001000000000001
100000000001000000000001
100000000001000000000001
100000000001000000000001
100000000001000000000001
100000000001000000000001
111111111111111111111111
